0 0 0 0 0 0 0 0 0 0 0 0 0 0 0 0 0 0 0 0 0 0 0 0 0 0 0 0 
0 1 1 1 1 1 1 1 1 1 1 1 1 0 0 1 1 1 1 1 1 1 1 1 1 1 1 0 
0 1 0 0 0 0 1 0 0 0 0 0 1 0 0 1 0 0 0 0 0 1 0 0 0 0 1 0 
0 1 0 0 0 0 1 0 0 0 0 0 1 0 0 1 0 0 0 0 0 1 0 0 0 0 1 0 
0 1 0 0 0 0 1 0 0 0 0 0 1 0 0 1 0 0 0 0 0 1 0 0 0 0 1 0 
0 1 1 1 1 1 1 1 1 1 1 1 1 1 1 1 1 1 1 1 1 1 1 1 1 1 1 0
0 1 0 0 0 0 1 0 0 1 0 0 0 0 0 0 0 0 1 0 0 1 0 0 0 0 1 0 
0 1 0 0 0 0 1 0 0 1 0 0 0 0 0 0 0 0 1 0 0 1 0 0 0 0 1 0 
0 1 1 1 1 1 1 0 0 1 1 1 1 0 0 1 1 1 1 0 0 1 1 1 1 1 1 0 
0 0 0 0 0 0 1 0 0 0 0 0 5 0 0 5 0 0 0 0 0 1 0 0 0 0 0 0
9 9 9 9 9 0 1 0 0 0 0 0 5 0 0 5 0 0 0 0 0 1 0 9 9 9 9 9
9 9 9 9 9 0 1 0 0 5 5 5 5 5 5 5 5 5 5 0 0 1 0 9 9 9 9 9
9 9 9 9 9 0 1 0 0 5 0 0 0 2 2 0 0 0 5 0 0 1 0 9 9 9 9 9
0 0 0 0 0 0 1 0 0 5 0 2 2 2 2 2 2 0 5 0 0 1 0 0 0 0 0 0
5 5 5 5 5 5 1 5 5 5 0 2 2 2 2 2 2 0 5 5 5 1 5 5 5 5 5 5
0 0 0 0 0 0 1 0 0 5 0 0 0 0 0 0 0 0 5 0 0 1 0 0 0 0 0 0
9 9 9 9 9 0 1 0 0 5 5 5 5 5 5 5 5 5 5 0 0 1 0 9 9 9 9 9
9 9 9 9 9 0 1 0 0 5 0 0 0 0 0 0 0 0 5 0 0 1 0 9 9 9 9 9
0 0 0 0 0 0 1 0 0 5 0 0 0 0 0 0 0 0 5 0 0 1 0 0 0 0 0 0
0 1 1 1 1 1 1 1 1 1 1 1 1 0 0 1 1 1 1 1 1 1 1 1 1 1 1 0 
0 1 0 0 0 0 1 0 0 0 0 0 1 0 0 1 0 0 0 0 0 1 0 0 0 0 1 0 
0 1 0 0 0 0 1 0 0 0 0 0 1 0 0 1 0 0 0 0 0 1 0 0 0 0 1 0 
0 1 1 1 0 0 1 1 1 1 1 1 1 5 5 1 1 1 1 1 1 1 0 0 1 1 1 0
0 0 0 1 0 0 1 0 0 1 0 0 0 0 0 0 0 0 1 0 0 1 0 0 1 0 0 0 
0 0 0 1 0 0 1 0 0 1 0 0 0 0 0 0 0 0 1 0 0 1 0 0 1 0 0 0 
0 1 1 1 1 1 1 0 0 1 1 1 1 0 0 1 1 1 1 0 0 1 1 1 1 1 1 0 
0 1 0 0 0 0 0 0 0 0 0 0 1 0 0 1 0 0 0 0 0 0 0 0 0 0 1 0 
0 1 0 0 0 0 0 0 0 0 0 0 1 0 0 1 0 0 0 0 0 0 0 0 0 0 1 0 
0 1 1 1 1 1 1 1 1 1 1 1 1 1 1 1 1 1 1 1 1 1 1 1 1 1 1 0 
0 0 0 0 0 0 0 0 0 0 0 0 0 0 0 0 0 0 0 0 0 0 0 0 0 0 0 0 